NO ./path_to_the_north_texture
SO ./path_to_the_south_texture
WE ./path_to_the_west_texture
EA ./path_to_the_east_texture
F 220,100,0
C 225,30,0

			1111111111111111111111111
1111111111111000000000000111111111111
			1011000001110000000000001
1111111111111000000000000111111111111
111111111011000001110000011
100000000011000001110111111111111
11110111111111011100000010001
11110111111111011101010010001
11000000110111111100000010001
100000000001    1100000010001
100000000001    1101010010001
11111111111111111111111111111
11111111111111111111111111111
11000011101111111111011110N0111
11110111 1110101 101111010001
11111111 1111111 111111111111