NO ./path_to_the_north_texture/hhhhh hhh.xpm
SO ./path_to_the_south_texture
WE ./path_to_the_west_texture
EA ./path_to_the_east_textu
F 220,100,0
C 225,30,0


11111
10011
1N001
10011
11111